1111111111
0000000001
1111111101
1111111101
1111111101
1111111100
1111111111
1111111111
1111111111
1111111111