1111111111
s000000001
1111111101
1111111101
1111111101
111111110f
1111111111
1111111111
1111111111
1111111111