1s1111111f
1000000010
1111111010
1111111010
1111111010
1111111000
1111111111
1111111111
1111111111
1111111111